11111111111111
1000000C0001E1
1C011111100101
1001000P1C0101
1X0001111X0001
11111111111111