11111111111111
1000000C0001P1
1C011111100101
100100001C0101
1X0001111X0E01
11111111111111