11111111111111
1000000C000101
1C011111100101
100100P01C0101
1X0001111X0E01
11111111111111