1111111
10XE0P1
10C0001
1111111