1111111
1CXE0P1
1000001
1111111