1111111
10XE1P1
10000C1
1111111