1111111
10XECP1
1000011
1111111