1111111111111111111111111111111111111111111111111111111
1111111111111111111111111111111111111111111111111111111
11P10C00000000010000000001X0000000000C0000000000C100X11
1101011111111101X11111010111110111111111111111110101C11
11010001X100000101C00001000000010C010000000001010101011
1101110101011111110111111111111101110111110101010101011
110000010100000001010000010001X000000100000100010101011
1111111101111111010101110101011101111101111111010111011
1100000001000C000100000100010001X0010001C0X100C10000011
1101111111011111111111111111110111110111011101111101E11
1111111111111111111111111111111111111111111111111111111